#######
#..#\*#
#..*..#
#.L##.#
#.R...#
#######
-END MINE
