#########
#\.....\#
####*####
#L.....R#
#########
-END MINE
