#########
#\     \#
####*####
#   .   #
#L   R  #
#########
-END MINE
