#####
#*.R#
#\..#
#\#.#
#\#.#
#\#.#
#\..#
##L##
-END MINE
