#######
#..R..#
#...*.#
#...*.#
#...*.#
#...*.#
#...*\#
#...*L#
#######
-END MINE
