#########
#.....*\#
#......*#
#.####.*#
#.****.*#
#R......#
######L##
-END MINE
