   #####
   #\#*#
   #.L\#
####.#.#
#....#.#
#.####.#
#.R....#
########
-END MINE
