  ##L##
###\\\#
#\\\*\#
#\*\*\#
#\*R*\#
#\#**\#
#\\\\\#
#######
-END MINE
