 ##### 
##***##
#R\\\.#
##\\\.#
 ###L##
-END MINE
