 #####  
##*#*###
#.\R\  #
##.#*# #
 #.#*# #
 #.#*# #
 #L#.  #
 #######
-END MINE
