#############
#********#**#
#\.R.\......#
#.......*...#
#\.......L..#
########...##
       ##### 
-END MINE
