####*#######
#L#\...*...#
#R####.*##.#
#.#**#.#**\#
#........* #
#.#\.#.#####
#.####.#    
###  ###    
-END MINE
