#########   
#.*..#\.#   
#.\..#\.L   
#.R .##.#   
#.\  ...#   
#..\  ..#   
#...\  ##   
#....\ \#   
#########   

Water 2
Flooding 11
Waterproof 5
-END MINE
