############ 
#..........# 
#.....*....# 
#..\\\\\\..# 
#.     ....# 
#..\\\\\\\.# 
#..\..    .# 
#..\.. ....# 
#..... ..* # 
#..### ### # 
#...R#\#\\.# 
######L##### 

Water 2
Flooding 10
Waterproof 10
-END MINE
