########
#..R...#
#..*...#
#..#...#
#.\.\..L
####**.#
#\.....#
#\..* .#
########
-END MINE
