#######
#    ##
#* .# #
#\ \* #
# .  *#
## LR\#
#######
-END MINE
#######
#    ##
#  .# #
#\*\  #
# . **#
## LR\#
#######
-END MINE
