#######
#   L #
# .# .#
# R \ #
# *. ##
#\#*  #
#######
-END MINE
