#######
##   *#
# \  \#
#  *# #
# *R. #
#L. \ #
#######
-END MINE
