#######
#*.   #
#  .# #
##RL*.#
#\   ##
#   \ #
#######
-END MINE
#######
# .   #
#* .# #
##RL .#
#\  *##
#   \ #
#######
-END MINE
