######################
#* *#**# #\ \ # \  . #
#   .    ..**. **    #
#..#* L.    . .\.#* \#
# \   .    .  *  . # #
#      ..*   # #  .\ #
#  \ \\\  *#*  .\ #  #
# .  .##\   .    * *.#
#\**.   #.#\ *\ . \ *#
##   # * *    .  .*  #
# #      \**     \  ##
#* \ #*   \ \  \*  . #
# \        .##  #   ##
#  #\.  .#    *###   #
##  #  .* .* \  * .\ #
# \.R**\    \.#.  ##.#
#  #   #   \ #\  #   #
# . *\\  *# #   \    #
#.#      \     *.  **#
#\ *.\. \# #  \   \\ #
#*    # * \ . *   * \#
######################
-END MINE
######################
#   #  # #\ \ # \  . #
#* *.**  .. *. **    #
#..#  L.   *. .\.#  \#
# \ * .    .     .*# #
#      ..    #*#  .\ #
#  \ \\\ * #*  .\ #  #
# .  .##\ * .       .#
#\  .   #.#\  \ .*\* #
##** #   *   *.  .  *#
# #    * \*      \* ##
#  \ #    \*\  \*  . #
#*\   *    .##  #   ##
#  #\.  .#     ###   #
##  #  .  .  \*   .\ #
# \.R  \*  *\.#.* ##.#
#  # **#   \ #\  #   #
# .  \\  *# #   \    #
#.# *    \      .  * #
#\  .\. \# #  \*  \\*#
#* *  # * \ . *   * \#
######################
-END MINE
######################
#   #  # #\ \ # \  . #
#* *. *  .. *. **    #
#..# *L.   *. .\.#  \#
# \   .    .     .*# #
#   *  ..    # #  .\ #
#  \ \\\   #* *.\ #  #
# .  .##\** .       .#
#\  .   #.#\  \ .*\  #
##*  #   *    .  . **#
# #*     \*  *   \  ##
#  \ # *  \*\  \* *. #
# \        .##  #   ##
#* #\.* .#     ###   #
##  #  .  .  \*   .\ #
# \.R  \   *\.#.  ##.#
#  # **#*  \ #\ *#   #
# .  \\  *# #   \    #
#.# *    \      .  * #
#\  .\. \# #  \   \\*#
#* *  # * \ . **  * \#
######################
-END MINE
######################
#   #  # #\ \ # \  . #
#* *. *  .. *. **    #
#..#  L.   *. .\.#  \#
# \  *.    .     .*# #
#      ..    # #  .\ #
#  \*\\\   #*  .\ #  #
# .  .##\** . *     .#
#\  .   #.#\  \ .*\  #
##*  #   *    .  .  *#
# #      \*      \ *##
#  \*#    \*\* \*  . #
# \    *   .##  # * ##
#* #\.  .#     ###   #
##  # *.  .  \*   .\ #
# \.R  \   *\.#.  ##.#
#  # **#   \ #\ *#   #
# .  \\ **# #   \    #
#.# *    \      .  * #
#\  .\. \# #  \   \\*#
#* *  # * \ . **  * \#
######################
-END MINE
######################
#   #  # #\ \ # \  . #
#* *. *  .. *. **    #
#..#  L.   *. .\.#  \#
# \   .    .     .*# #
#    * ..    # #  .\ #
#  \ \\\   #*  .\ #  #
# . *.##\** .       .#
#\  .   #.#\  \*.*\  #
##*  #   *    .  .  *#
# #      \*      \ *##
#  \ #    \*\* \*  . #
# \ *      .##  #   ##
#* #\. *.#     ###*  #
##  #  .  .  \*   .\ #
# \.R *\   *\.#.  ##.#
#  # **#   \ #\ *#   #
# .  \\  *# #   \    #
#.# *   *\      .  * #
#\  .\. \# #  \   \\*#
#* *  # * \ . **  * \#
######################
-END MINE
######################
#   #  # #\ \ # \  . #
#* *. *  .. *. **    #
#..#  L.   *. .\.#  \#
# \   .    .     .*# #
#    * ..    # #  .\ #
#  \ \\\   #*  .\ #  #
# . *.##\** .       .#
#\  .   #.#\  \ .*\  #
##*  #   *    .* .  *#
# #      \*      \ *##
#  \ #    \*\* \*  . #
# \ *      .##  #   ##
#* #\. *.#     ###*  #
##  #  .  .  \*   .\ #
# \.R *\   *\.#.  ##.#
#  # **#   \ #\ *#   #
# .  \\  *# #   \    #
#.# *   *\      .  * #
#\  .\. \# #  \   \\*#
#* *  # * \ . **  * \#
######################
-END MINE
######################
#   #  # #\ \ # \  . #
#* *. *  .. *. **    #
#..#  L.   *. .\.#  \#
# \   .    .     .*# #
#    * ..    # #  .\ #
#  \ \\\   #*  .\ #  #
# . *.##\** .       .#
#\  .   #.#\  \ .*\  #
##*  #   *    .  .  *#
# #      \*    * \ *##
#  \ #    \*\* \*  . #
# \ *      .##  #   ##
#* #\. *.#     ###*  #
##  #  .  .  \*   .\ #
# \.R *\   *\.#.  ##.#
#  # **#   \ #\ *#   #
# .  \\  *# #   \    #
#.# *   *\      .  * #
#\  .\. \# #  \   \\*#
#* *  # * \ . **  * \#
######################
-END MINE
